~  ~  ~  ~  ~  ~  ~  ~  ~  ~  ~  ~  ~  ~  ~  ~  ~  ~  ~  ~  ~  ~  ~  ~  ~  ~  ~  ~  ~  k  
~  ~  ~  ~  ~  ~  ~  ~  ~  ~  ~  ~  ~  ~  ~  ~  ~  ~  ~  ~  ~  ~  ~  ~  ~  ~  ~  ~  ~  ~  
~  ~  ~  ~  ~  ~  ~  ~  ~  ~  ~  ~  ~  ~  ~  ~  ~  ~  ~  ~  ~  ~  ~  ~  ~  ~  ~  ~  ~  ~  
~  ~  ~  ~  ~  ~  ~  ~  ~  ~  ~  ~  ~  ~  ~  ~  ~  ~  ~  ~  ~  ~  ~  ~  ~  ~  ~  ~  ~  ~  
~  ~  ~  ~  ~  ~  ~  ~  ~  ~  ~  ~  ~  ~  ~  ~  ~  ~  ~  ~  ~  ~  ~  ~  ~  ~  ~  ~  ~  ~  
~  ~  ~  ~  ~  #  #  #  #  #  #  #  #  #  #  #  #  ~  ~  ~  ~  ~  ~  ~  ~  ~  ~  ~  ~  ~  
~  ~  ~  ~  ~  #  ~  ~  ~  ~  ~  ~  ~  ~  ~  ~  #  ~  ~  ~  ~  ~  ~  ~  ~  ~  ~  ~  ~  ~  
~  ~  ~  ~  ~  #  ~  #  #  #  #  #  #  ~  ~  ~  #  ~  ~  ~  ~  ~  ~  ~  ~  ~  ~  ~  ~  ~  
~  ~  ~  ~  ~  #  ~  #  b  #  #  #  #  ~  ~  ~  #  ~  ~  ~  ~  ~  ~  ~  ~  ~  ~  ~  ~  ~  
~  ~  ~  ~  ~  #  ~  #  ~  ~  ~  ~  #  ~  ~  ~  #  ~  ~  ~  ~  #  #  ~  #  #  #  #  #  ~  
~  ~  ~  ~  ~  #  ~  #  ~  #  #  ~  #  ~  ~  ~  #  ~  ~  ~  ~  #  #  ~  #  #  #  #  #  ~  
~  ~  ~  ~  ~  #  ~  #  ~  ~  #  ~  #  ~  ~  ~  #  ~  ~  ~  ~  z  z  z  z  z  z  z  z  ~  
~  ~  ~  ~  ~  #  ~  #  #  ~  #  ~  #  ~  ~  ~  #  #  #  #  #  #  #  ~  ~  ~  ~  ~  ~  ~  
~  ~  ~  ~  ~  #  ~  #  ~  ~  #  ~  #  ~  ~  ~  ~  ~  ~  ~  ~  ~  #  ~  ~  ~  ~  ~  ~  ~  
~  ~  ~  ~  ~  #  ~  #  ~  #  #  ~  #  ~  ~  ~  ~  ~  ~  ~  ~  ~  #  ~  ~  ~  ~  ~  ~  ~  
~  ~  ~  ~  ~  #  ~  ~  ~  #  ~  ~  #  ~  ~  ~  ~  ~  ~  ~  ~  ~  #  ~  ~  ~  ~  ~  ~  ~  
~  ~  ~  ~  ~  #  ~  ~  #  #  ~  ~  #  ~  ~  ~  ~  ~  ~  ~  #  ~  #  ~  ~  ~  ~  ~  ~  ~  
~  ~  ~  ~  ~  #  #  #  #  #  #  ~  #  ~  ~  ~  ~  ~  ~  #  #  ~  #  ~  ~  ~  ~  ~  ~  ~  
~  ~  ~  ~  ~  ~  ~  ~  ~  #  #  ~  #  #  ~  ~  ~  ~  #  #  #  ~  #  ~  ~  ~  ~  ~  ~  ~  
~  ~  ~  ~  ~  ~  ~  ~  ~  #  #  ~  #  #  ~  ~  ~  #  #  ~  #  ~  #  ~  ~  ~  ~  ~  ~  ~  
~  ~  ~  ~  ~  ~  ~  ~  ~  #  #  @  #  #  ~  ~  #  #  ~  ~  #  ~  #  ~  ~  ~  ~  ~  ~  ~  
~  ~  ~  ~  ~  ~  ~  ~  ~  #  #  #  #  #  ~  #  #  ~  ~  ~  ~  ~  ~  ~  ~  ~  ~  ~  ~  ~  
~  ~  ~  ~  ~  ~  ~  ~  ~  #  #  #  #  #  #  #  ~  ~  ~  ~  ~  ~  ~  ~  ~  ~  #  #  #  ~  
+  +  +  ~  ~  ~  ~  ~  ~  ~  ~  ~  ~  ~  ~  ~  ~  ~  ~  ~  ~  ~  ~  ~  ~  ~  ~  ~  ~  ~  
#  #  +  ~  ~  ~  ~  ~  ~  ~  ~  ~  ~  ~  ~  ~  ~  ~  ~  ~  ~  ~  ~  ~  k  !  !  !  !  !  
~  #  +  ~  ~  ~  ~  ~  ~  ~  ~  ~  ~  ~  ~  ~  ~  ~  ~  ~  ~  ~  ~  #  !  !  !  !  !  !  
~  #  +  ~  ~  ~  ~  ~  ~  ~  ~  ~  ~  ~  ~  ~  ~  ~  ~  ~  ~  ~  ~  #  !  !  k  k  k  k  
~  #  #  ~  ~  ~  ~  ~  ~  ~  ~  ~  ~  ~  ~  ~  ~  ~  ~  ~  ~  ~  ~  ~  !  !  k  z  b  k  
~  ~  ~  ~  ~  ~  ~  ~  ~  ~  ~  ~  ~  ~  ~  ~  ~  ~  ~  ~  ~  ~  ~  #  !  !  k  b  z  k  
k  ~  ~  ~  ~  ~  ~  ~  ~  ~  ~  ~  ~  ~  ~  ~  ~  ~  ~  ~  ~  ~  ~  ~  !  !  k  k  k  k  
