~  ~  ~  ~  #  ~  ~  ~  #  ~  ~  ~  #  ~  ~  ~  #  k  #  ~  ~  ~  #  ~  ~  ~  #  ~  ~  ~  
~  ~  #  ~  #  $  #  %  #  ~  #  ~  #  ~  #  ~  #  k  #  ~  #  ~  #  ~  #  ~  #  ~  #  @  
#  #  #  ~  #  $  #  %  #  ~  #  ~  #  ~  #  ~  #  k  #  ~  #  ~  #  ~  #  ~  #  ~  #  #  
!  !  !  ~  #  $  #  %  #  ~  #  ~  #  ~  #  ~  #  k  #  ~  #  ~  #  ~  #  ~  #  ~  ~  ~  
!  #  #  #  #  $  #  %  #  ~  #  ~  #  ~  #  ~  #  ~  #  ~  #  ~  #  ~  #  ~  #  #  #  ~  
!  !  !  !  !  $  #  %  #  ~  #  ~  #  ~  #  ~  #  ~  #  ~  #  ~  #  ~  #  ~  ~  ~  ~  ~  
#  #  #  #  #  #  #  %  #  ~  #  ~  #  ~  #  ~  #  ~  #  ~  #  ~  #  ~  #  #  #  #  #  #  
~  ~  ~  ~  ~  ~  ~  ~  #  ~  #  ~  #  ~  #  ~  #  ~  ~  ~  #  ~  #  k  k  k  k  k  ~  ~  
~  #  #  #  #  #  #  #  #  ~  #  ~  #  ~  #  ~  #  ~  #  ~  #  ~  #  #  #  #  #  #  #  ~  
~  ~  ~  ~  ~  ~  &  &  &  &  #  ~  #  ~  #  ~  #  ~  #  ~  #  ~  ~  ~  ~  ~  ~  ~  ~  ~  
#  #  #  #  #  #  #  #  #  #  #  ~  #  ~  #  ~  #  ~  #  ~  #  #  #  #  #  #  #  #  #  #  
~  ~  ~  ~  ~  ~  ~  ~  ~  ~  ~  ~  #  ~  #  ~  #  ~  #  b  b  b  k  k  k  k  k  k  ~  ~  
~  #  #  #  #  #  #  #  #  #  #  #  #  ~  #  ~  #  ~  #  #  #  #  #  #  #  #  #  #  #  ~  
~  ~  ~  ~  ~  ~  ~  ~  ~  &  &  &  &  &  #  ~  #  ~  ~  ~  ~  ~  ~  ~  ~  ~  ~  ~  ~  ~  
#  #  #  #  #  #  #  #  #  #  #  #  #  #  #  ~  #  #  #  #  #  #  #  ~  #  #  #  #  #  #  
~  ~  ~  ~  ~  ~  ~  ~  ~  ~  ~  ~  ~  ~  ~  ~  #  ~  ~  ~  ~  ~  ~  ~  ~  ~  ~  ~  ~  ~  
~  #  #  #  #  #  #  #  #  #  #  #  #  #  #  #  #  k  ~  #  #  #  #  #  #  #  #  #  #  #  
~  ~  ~  ~  ~  ~  ~  ~  ~  ~  ~  ~  ~  ~  ~  ~  ~  #  k  ~  ~  ~  ~  ~  ~  ~  ~  ~  ~  ~  
#  #  #  #  #  #  #  #  #  z  #  #  #  #  #  #  #  k  #  k  #  #  #  #  #  #  #  #  #  ~  
~  ~  ~  ~  ~  ~  ~  ~  ~  ~  ~  ~  ~  ~  ~  ~  ~  ~  ~  #  k  ~  ~  ~  ~  ~  ~  ~  ~  ~  
#  #  #  #  #  #  #  #  #  #  #  #  #  #  #  #  #  #  ~  ~  #  k  ~  #  #  #  #  #  #  #  
~  ~  ~  ~  ~  ~  ~  ~  ~  ~  ~  ~  ~  ~  ~  ~  ~  ~  ~  ~  ~  #  k  ~  ~  ~  ~  ~  ~  ~  
~  ~  ~  ~  ~  ~  ~  b  b  b  b  b  b  b  b  b  ~  ~  &  &  &  ~  #  k  #  #  #  #  #  ~  
~  ~  ~  ~  ~  ~  ~  ~  ~  ~  ~  ~  ~  ~  ~  ~  ~  ~  ~  ~  ~  ~  #  #  k  ~  ~  ~  ~  ~  
~  k  ~  k  ~  k  k  k  ~  k  ~  ~  ~  k  ~  ~  ~  k  k  k  ~  k  #  ~  #  k  ~  #  #  #  
~  k  ~  k  ~  k  ~  ~  ~  k  ~  ~  ~  k  ~  ~  ~  k  ~  k  ~  k  #  ~  ~  #  k  ~  ~  ~  
~  k  k  k  ~  k  k  ~  ~  k  ~  ~  ~  k  ~  ~  ~  k  ~  k  ~  k  #  ~  ~  ~  #  k  #  ~  
~  k  ~  k  ~  k  ~  ~  ~  k  ~  ~  ~  k  ~  ~  ~  k  ~  k  ~  ~  #  ~  #  ~  #  #  k  ~  
~  k  ~  k  ~  k  k  k  ~  k  k  k  ~  k  k  k  ~  k  k  k  ~  k  #  ~  #  ~  #  ~  #  ~  
~  ~  ~  ~  ~  ~  ~  ~  ~  ~  ~  ~  ~  ~  ~  ~  ~  ~  ~  ~  ~  ~  ~  ~  #  ~  ~  ~  ~  ~  
