~  ~  #  ~  ~  ~  ~  ~  ~  ~  ~  ~  ~  ~  ~  ~  ~  ~  ~  ~  ~  ~  ~  ~  ~  ~  ~  ~  k  #  
~  #  @  #  ~  ~  ~  ~  ~  ~  ~  ~  ~  ~  ~  ~  ~  ~  ~  ~  ~  ~  ~  ~  ~  ~  ~  ~  k  #  
~  ~  #  ~  ~  ~  ~  ~  ~  ~  ~  !  ~  ~  ~  ~  ~  ~  ~  ~  ~  ~  ~  !  ~  ~  ~  ~  ~  #  
~  ~  #  ~  ~  ~  ~  ~  ~  ~  ~  ~  ~  ~  ~  ~  ~  ~  ~  ~  ~  ~  ~  !  ~  ~  ~  ~  ~  #  
~  ~  #  ~  ~  ~  ~  ~  ~  ~  ~  ~  ~  !  !  !  !  !  !  !  ~  ~  ~  !  ~  ~  ~  ~  ~  #  
~  ~  #  ~  ~  ~  ~  ~  ~  ~  ~  ~  ~  ~  ~  ~  ~  ~  ~  !  !  ~  ~  !  ~  ~  ~  ~  ~  #  
~  ~  #  #  #  #  #  ~  ~  ~  ~  ~  ~  ~  ~  ~  ~  ~  ~  !  !  ~  ~  !  ~  ~  ~  ~  ~  #  
~  ~  ~  ~  ~  ~  #  ~  ~  ~  ~  !  ~  ~  ~  ~  ~  ~  ~  !  !  ~  ~  !  ~  ~  ~  ~  ~  #  
~  ~  ~  ~  ~  ~  #  ~  ~  ~  ~  ~  ~  ~  ~  ~  ~  ~  ~  ~  ~  ~  ~  !  ~  ~  ~  ~  ~  #  
~  ~  ~  ~  ~  ~  #  ~  ~  ~  ~  ~  ~  ~  ~  ~  ~  ~  ~  !  ~  ~  ~  !  ~  ~  ~  ~  ~  #  
~  ~  ~  ~  ~  ~  #  #  #  #  #  !  ~  ~  ~  !  ~  ~  ~  ~  ~  ~  ~  !  ~  ~  ~  ~  ~  #  
~  ~  ~  ~  ~  ~  ~  ~  ~  ~  #  ~  ~  ~  ~  ~  ~  ~  ~  ~  ~  ~  ~  !  ~  ~  ~  ~  ~  #  
~  ~  ~  ~  ~  ~  ~  ~  ~  ~  #  ~  ~  ~  ~  ~  ~  ~  ~  ~  ~  ~  ~  !  ~  ~  ~  ~  ~  #  
~  ~  ~  ~  ~  ~  ~  ~  ~  ~  #  ~  ~  ~  ~  ~  ~  ~  ~  ~  ~  ~  ~  !  ~  ~  ~  ~  ~  #  
~  ~  ~  ~  ~  ~  ~  ~  ~  ~  #  #  #  #  #  !  ~  ~  ~  !  ~  ~  ~  !  !  !  !  ~  ~  #  
~  ~  ~  ~  ~  ~  ~  ~  ~  ~  ~  ~  ~  ~  #  ~  ~  ~  ~  ~  ~  ~  ~  ~  ~  b  ~  ~  ~  #  
~  ~  ~  ~  #  ~  ~  ~  ~  ~  ~  ~  ~  ~  #  ~  ~  ~  ~  ~  ~  ~  ~  ~  ~  b  b  ~  ~  #  
~  ~  ~  #  #  ~  ~  ~  ~  ~  ~  ~  ~  ~  #  b  b  b  b  b  b  b  b  b  b  b  b  b  ~  ~  
~  ~  #  #  #  #  #  #  #  ~  ~  ~  ~  ~  #  #  #  #  #  k  k  k  k  k  k  b  b  ~  ~  #  
~  ~  ~  #  #  ~  ~  ~  ~  ~  ~  ~  ~  ~  ~  ~  ~  ~  #  k  k  k  k  k  k  b  ~  ~  ~  #  
~  ~  ~  ~  #  ~  ~  ~  ~  ~  ~  ~  ~  ~  ~  ~  ~  ~  #  k  k  k  k  k  k  b  ~  ~  ~  #  
~  ~  ~  ~  ~  ~  ~  ~  ~  ~  ~  ~  ~  ~  ~  ~  ~  ~  #  k  k  k  k  k  k  b  ~  ~  ~  #  
~  ~  ~  ~  ~  ~  ~  ~  ~  ~  ~  ~  ~  ~  ~  ~  ~  ~  #  #  #  #  #  k  k  b  ~  ~  ~  #  
~  ~  ~  ~  ~  ~  ~  ~  ~  ~  ~  ~  ~  ~  ~  ~  ~  ~  ~  ~  ~  ~  #  b  b  b  b  ~  ~  #  
~  ~  ~  ~  ~  ~  ~  ~  ~  ~  ~  ~  ~  ~  ~  ~  ~  ~  ~  ~  ~  ~  #  k  k  k  b  ~  ~  #  
~  ~  ~  ~  ~  ~  ~  ~  ~  ~  ~  ~  ~  ~  ~  ~  ~  ~  ~  ~  ~  ~  #  k  k  k  ~  ~  ~  #  
~  ~  ~  ~  ~  ~  ~  ~  ~  ~  ~  ~  ~  ~  ~  ~  ~  ~  ~  ~  ~  ~  #  #  #  #  #  ~  ~  #  
~  ~  ~  ~  ~  ~  ~  ~  ~  ~  ~  ~  ~  ~  ~  ~  ~  ~  ~  ~  ~  ~  k  k  k  k  #  ~  ~  #  
~  ~  ~  ~  ~  ~  ~  ~  ~  ~  ~  ~  ~  ~  ~  ~  ~  ~  ~  ~  ~  ~  k  k  k  k  #  ~  @  #  
~  ~  ~  ~  ~  ~  ~  ~  ~  ~  ~  ~  ~  ~  ~  ~  ~  ~  ~  ~  ~  ~  k  k  k  k  #  #  #  #  
